11 22 
0000000000322222222220
0000000003111111111300
0000000031111111113000
0000000311111111130000
0000003111111111300000
0000031111111113000000
0000311111111130000000
0003111111111300000000
0031111111113000000000
0311111111130000000000
2222222222200000000000