08 15
000000022222223
000000311111130
000003111111300
000031111113000
000311111130000
003111111300000
031111113000000
322222220000000
