06 11 06
00000222223
00003111130
00031111300
00311113000
03111130000
32222200000